"MUT";"SRUN";"SCT";"SAVGTCT";"SCTCT";"TRUN";"TCT";"TAVGTCT";"TCTCT"
1;126;126;1,06;1,06;102;102;0,86;0,86
2;115;241;0,97;2,03;121;223;1,02;1,87
3;115;356;0,97;2,99;120;343;1,01;2,88
4;115;471;0,97;3,96;121;464;1,02;3,90
5;115;586;0,97;4,92;120;584;1,01;4,91
6;115;701;0,97;5,89;120;704;1,01;5,92
7;115;816;0,97;6,86;120;824;1,01;6,92
8;115;931;0,97;7,82;120;944;1,01;7,93
9;115;1046;0,97;8,79;120;1064;1,01;8,94
10;115;1161;0,97;9,76;120;1184;1,01;9,95
11;115;1276;0,97;10,72;120;1304;1,01;10,96
12;115;1391;0,97;11,69;120;1424;1,01;11,97
13;118;1509;0,99;12,68;120;1544;1,01;12,97
14;117;1626;0,98;13,66;120;1664;1,01;13,98
15;117;1743;0,98;14,65;120;1784;1,01;14,99
16;117;1860;0,98;15,63;120;1904;1,01;16,00
17;117;1977;0,98;16,61;120;2024;1,01;17,01
18;116;2093;0,97;17,59;120;2144;1,01;18,02
19;117;2210;0,98;18,57;120;2264;1,01;19,03
20;117;2327;0,98;19,55;120;2384;1,01;20,03
21;117;2444;0,98;20,54;120;2504;1,01;21,04
22;116;2560;0,97;21,51;120;2624;1,01;22,05
23;116;2676;0,97;22,49;120;2744;1,01;23,06
24;116;2792;0,97;23,46;120;2864;1,01;24,07
25;116;2908;0,97;24,44;120;2984;1,01;25,08
26;116;3024;0,97;25,41;120;3104;1,01;26,08
27;115;3139;0,97;26,38;120;3224;1,01;27,09
28;115;3254;0,97;27,34;121;3345;1,02;28,11
29;115;3369;0,97;28,31;120;3465;1,01;29,12
30;114;3483;0,96;29,27;120;3585;1,01;30,13
31;114;3597;0,96;30,23;120;3705;1,01;31,13
32;114;3711;0,96;31,18;120;3825;1,01;32,14
33;114;3825;0,96;32,14;120;3945;1,01;33,15
34;114;3939;0,96;33,10;120;4065;1,01;34,16
35;115;4054;0,97;34,07;120;4185;1,01;35,17
36;115;4169;0,97;35,03;120;4305;1,01;36,18
37;114;4283;0,96;35,99;120;4425;1,01;37,18
38;115;4398;0,97;36,96;120;4545;1,01;38,19
39;115;4513;0,97;37,92;120;4665;1,01;39,20
40;115;4628;0,97;38,89;120;4785;1,01;40,21
41;115;4743;0,97;39,86;120;4905;1,01;41,22
42;115;4858;0,97;40,82;120;5025;1,01;42,23
43;115;4973;0,97;41,79;120;5145;1,01;43,24
44;114;5087;0,96;42,75;120;5265;1,01;44,24
45;115;5202;0,97;43,71;120;5385;1,01;45,25
46;115;5317;0,97;44,68;120;5505;1,01;46,26
47;115;5432;0,97;45,65;120;5625;1,01;47,27
48;115;5547;0,97;46,61;120;5745;1,01;48,28
49;113;5660;0,95;47,56;120;5865;1,01;49,29
50;115;5775;0,97;48,53;120;5985;1,01;50,29
51;113;5888;0,95;49,48;120;6105;1,01;51,30
52;113;6001;0,95;50,43;120;6225;1,01;52,31
53;115;6116;0,97;51,39;120;6345;1,01;53,32
54;115;6231;0,97;52,36;120;6465;1,01;54,33
55;116;6347;0,97;53,34;120;6585;1,01;55,34
56;116;6463;0,97;54,31;120;6705;1,01;56,34
57;116;6579;0,97;55,29;120;6825;1,01;57,35
58;116;6695;0,97;56,26;120;6945;1,01;58,36
59;116;6811;0,97;57,24;120;7065;1,01;59,37
60;116;6927;0,97;58,21;121;7186;1,02;60,39
61;116;7043;0,97;59,18;121;7307;1,02;61,40
62;116;7159;0,97;60,16;120;7427;1,01;62,41
63;116;7275;0,97;61,13;120;7547;1,01;63,42
64;116;7391;0,97;62,11;120;7667;1,01;64,43
65;116;7507;0,97;63,08;120;7787;1,01;65,44
66;116;7623;0,97;64,06;120;7907;1,01;66,45
67;116;7739;0,97;65,03;121;8028;1,02;67,46
68;117;7856;0,98;66,02;120;8148;1,01;68,47
69;116;7972;0,97;66,99;120;8268;1,01;69,48
70;116;8088;0,97;67,97;120;8388;1,01;70,49
71;116;8204;0,97;68,94;120;8508;1,01;71,50
72;116;8320;0,97;69,92;120;8628;1,01;72,50
73;116;8436;0,97;70,89;120;8748;1,01;73,51
74;116;8552;0,97;71,87;120;8868;1,01;74,52
75;116;8668;0,97;72,84;121;8989;1,02;75,54
76;116;8784;0,97;73,82;121;9110;1,02;76,55
77;116;8900;0,97;74,79;120;9230;1,01;77,56
78;116;9016;0,97;75,76;121;9351;1,02;78,58
79;116;9132;0,97;76,74;120;9471;1,01;79,59
80;116;9248;0,97;77,71;120;9591;1,01;80,60
81;116;9364;0,97;78,69;120;9711;1,01;81,61
82;116;9480;0,97;79,66;120;9831;1,01;82,61
83;116;9596;0,97;80,64;120;9951;1,01;83,62
84;116;9712;0,97;81,61;120;10071;1,01;84,63
85;116;9828;0,97;82,59;120;10191;1,01;85,64
86;117;9945;0,98;83,57;120;10311;1,01;86,65
87;117;10062;0,98;84,55;120;10431;1,01;87,66
88;117;10179;0,98;85,54;121;10552;1,02;88,67
89;116;10295;0,97;86,51;120;10672;1,01;89,68
90;117;10412;0,98;87,50;120;10792;1,01;90,69
91;117;10529;0,98;88,48;120;10912;1,01;91,70
92;117;10646;0,98;89,46;120;11032;1,01;92,71
93;117;10763;0,98;90,45;120;11152;1,01;93,71
94;116;10879;0,97;91,42;120;11272;1,01;94,72
95;117;10996;0,98;92,40;120;11392;1,01;95,73
96;116;11112;0,97;93,38;120;11512;1,01;96,74
97;116;11228;0,97;94,35;121;11633;1,02;97,76
98;116;11344;0,97;95,33;121;11754;1,02;98,77
99;116;11460;0,97;96,30;121;11875;1,02;99,79
100;116;11576;0,97;97,28;120;11995;1,01;100,80
101;116;11692;0,97;98,25;121;12116;1,02;101,82
102;116;11808;0,97;99,23;120;12236;1,01;102,82
103;116;11924;0,97;100,20;121;12357;1,02;103,84
104;116;12040;0,97;101,18;121;12478;1,02;104,86
105;116;12156;0,97;102,15;121;12599;1,02;105,87
106;117;12273;0,98;103,13;121;12720;1,02;106,89
107;116;12389;0,97;104,11;121;12841;1,02;107,91
108;116;12505;0,97;105,08;121;12962;1,02;108,92
109;116;12621;0,97;106,06;120;13082;1,01;109,93
110;117;12738;0,98;107,04;121;13203;1,02;110,95
111;117;12855;0,98;108,03;121;13324;1,02;111,97
112;116;12971;0,97;109,00;120;13444;1,01;112,97
113;116;13087;0,97;109,97;121;13565;1,02;113,99
114;116;13203;0,97;110,95;121;13686;1,02;115,01
115;116;13319;0,97;111,92;120;13806;1,01;116,02
116;116;13435;0,97;112,90;121;13927;1,02;117,03
117;117;13552;0,98;113,88;120;14047;1,01;118,04
118;116;13668;0,97;114,86;121;14168;1,02;119,06
119;116;13784;0,97;115,83;121;14289;1,02;120,08
120;117;13901;0,98;116,82;122;14411;1,03;121,10
121;117;14018;0,98;117,80;121;14532;1,02;122,12
122;117;14135;0,98;118,78;121;14653;1,02;123,13
123;116;14251;0,97;119,76;121;14774;1,02;124,15
124;117;14368;0,98;120,74;120;14894;1,01;125,16
125;117;14485;0,98;121,72;121;15015;1,02;126,18
126;118;14603;0,99;122,71;121;15136;1,02;127,19
127;116;14719;0,97;123,69;121;15257;1,02;128,21
128;117;14836;0,98;124,67;121;15378;1,02;129,23
129;117;14953;0,98;125,66;121;15499;1,02;130,24
130;116;15069;0,97;126,63;121;15620;1,02;131,26
131;117;15186;0,98;127,61;121;15741;1,02;132,28
132;117;15303;0,98;128,60;121;15862;1,02;133,29
133;116;15419;0,97;129,57;121;15983;1,02;134,31
134;117;15536;0,98;130,55;121;16104;1,02;135,33
135;116;15652;0,97;131,53;121;16225;1,02;136,34
136;117;15769;0,98;132,51;121;16346;1,02;137,36
137;117;15886;0,98;133,50;121;16467;1,02;138,38
138;117;16003;0,98;134,48;121;16588;1,02;139,39
139;117;16120;0,98;135,46;121;16709;1,02;140,41
140;116;16236;0,97;136,44;121;16830;1,02;141,43
141;116;16352;0,97;137,41;121;16951;1,02;142,45
142;117;16469;0,98;138,39;121;17072;1,02;143,46
143;116;16585;0,97;139,37;121;17193;1,02;144,48
144;117;16702;0,98;140,35;121;17314;1,02;145,50
145;116;16818;0,97;141,33;121;17435;1,02;146,51
146;116;16934;0,97;142,30;121;17556;1,02;147,53
147;116;17050;0,97;143,28;121;17677;1,02;148,55
148;117;17167;0,98;144,26;121;17798;1,02;149,56
149;111;17278;0,93;145,19;118;17916;0,99;150,55
150;111;17389;0,93;146,13;117;18033;0,98;151,54
151;111;17500;0,93;147,06;118;18151;0,99;152,53
152;111;17611;0,93;147,99;118;18269;0,99;153,52
153;111;17722;0,93;148,92;118;18387;0,99;154,51
154;111;17833;0,93;149,86;118;18505;0,99;155,50
155;111;17944;0,93;150,79;118;18623;0,99;156,50
156;117;18061;0,98;151,77;121;18744;1,02;157,51
157;117;18178;0,98;152,76;121;18865;1,02;158,53
158;116;18294;0,97;153,73;121;18986;1,02;159,55
159;117;18411;0,98;154,71;122;19108;1,03;160,57
160;112;18523;0,94;155,66;118;19226;0,99;161,56
161;117;18640;0,98;156,64;121;19347;1,02;162,58
162;117;18757;0,98;157,62;121;19468;1,02;163,60
163;117;18874;0,98;158,61;121;19589;1,02;164,61
164;117;18991;0,98;159,59;121;19710;1,02;165,63
165;117;19108;0,98;160,57;121;19831;1,02;166,65
166;117;19225;0,98;161,55;121;19952;1,02;167,66
167;115;19340;0,97;162,52;120;20072;1,01;168,67
168;117;19457;0,98;163,50;121;20193;1,02;169,69
169;112;19569;0,94;164,45;118;20311;0,99;170,68
170;112;19681;0,94;165,39;118;20429;0,99;171,67
171;112;19793;0,94;166,33;118;20547;0,99;172,66
172;113;19906;0,95;167,28;118;20665;0,99;173,66
173;113;20019;0,95;168,23;118;20783;0,99;174,65
174;112;20131;0,94;169,17;118;20901;0,99;175,64
175;113;20244;0,95;170,12;118;21019;0,99;176,63
176;107;20351;0,90;171,02;115;21134;0,97;177,60
177;107;20458;0,90;171,92;115;21249;0,97;178,56
178;107;20565;0,90;172,82;115;21364;0,97;179,53
179;117;20682;0,98;173,80;121;21485;1,02;180,55
180;107;20789;0,90;174,70;115;21600;0,97;181,51
181;107;20896;0,90;175,60;115;21715;0,97;182,48
182;107;21003;0,90;176,50;115;21830;0,97;183,45
183;118;21121;0,99;177,49;121;21951;1,02;184,46
184;126;21247;1,06;178,55;132;22083;1,11;185,57
185;116;21363;0,97;179,52;120;22203;1,01;186,58
186;116;21479;0,97;180,50;121;22324;1,02;187,60
187;116;21595;0,97;181,47;121;22445;1,02;188,61
188;113;21708;0,95;182,42;119;22564;1,00;189,61
189;117;21825;0,98;183,40;121;22685;1,02;190,63
190;116;21941;0,97;184,38;121;22806;1,02;191,65
191;116;22057;0,97;185,35;121;22927;1,02;192,66
192;116;22173;0,97;186,33;121;23048;1,02;193,68
193;116;22289;0,97;187,30;121;23169;1,02;194,70
194;116;22405;0,97;188,28;121;23290;1,02;195,71
195;116;22521;0,97;189,25;121;23411;1,02;196,73
196;116;22637;0,97;190,23;121;23532;1,02;197,75
197;116;22753;0,97;191,20;121;23653;1,02;198,76
198;115;22868;0,97;192,17;121;23774;1,02;199,78
199;115;22983;0,97;193,13;121;23895;1,02;200,80
200;115;23098;0,97;194,10;121;24016;1,02;201,82
201;115;23213;0,97;195,07;121;24137;1,02;202,83
202;115;23328;0,97;196,03;121;24258;1,02;203,85
203;115;23443;0,97;197,00;122;24380;1,03;204,87
204;115;23558;0,97;197,97;121;24501;1,02;205,89
205;115;23673;0,97;198,93;121;24622;1,02;206,91
206;116;23789;0,97;199,91;121;24743;1,02;207,92
207;115;23904;0,97;200,87;121;24864;1,02;208,94
208;115;24019;0,97;201,84;122;24986;1,03;209,97
209;115;24134;0,97;202,81;122;25108;1,03;210,99
210;115;24249;0,97;203,77;122;25230;1,03;212,02
211;115;24364;0,97;204,74;121;25351;1,02;213,03
212;115;24479;0,97;205,71;122;25473;1,03;214,06
213;115;24594;0,97;206,67;121;25594;1,02;215,08
214;115;24709;0,97;207,64;122;25716;1,03;216,10
215;116;24825;0,97;208,61;121;25837;1,02;217,12
216;126;24951;1,06;209,67;132;25969;1,11;218,23
217;115;25066;0,97;210,64;121;26090;1,02;219,24
218;115;25181;0,97;211,61;122;26212;1,03;220,27
219;116;25297;0,97;212,58;121;26333;1,02;221,29
220;116;25413;0,97;213,55;122;26455;1,03;222,31
221;111;25524;0,93;214,49;119;26574;1,00;223,31
222;114;25638;0,96;215,45;121;26695;1,02;224,33
223;115;25753;0,97;216,41;122;26817;1,03;225,35
224;115;25868;0,97;217,38;121;26938;1,02;226,37
225;126;25994;1,06;218,44;132;27070;1,11;227,48
226;116;26110;0,97;219,41;122;27192;1,03;228,50
227;116;26226;0,97;220,39;122;27314;1,03;229,53
228;116;26342;0,97;221,36;122;27436;1,03;230,55
229;116;26458;0,97;222,34;122;27558;1,03;231,58
230;116;26574;0,97;223,31;122;27680;1,03;232,61
231;116;26690;0,97;224,29;125;27805;1,05;233,66
232;116;26806;0,97;225,26;126;27931;1,06;234,71
233;116;26922;0,97;226,24;126;28057;1,06;235,77
234;116;27038;0,97;227,21;125;28182;1,05;236,82
235;116;27154;0,97;228,18;126;28308;1,06;237,88
236;126;27280;1,06;229,24;132;28440;1,11;238,99
237;116;27396;0,97;230,22;122;28562;1,03;240,02
238;116;27512;0,97;231,19;121;28683;1,02;241,03
239;116;27628;0,97;232,17;122;28805;1,03;242,06
240;116;27744;0,97;233,14;122;28927;1,03;243,08
241;116;27860;0,97;234,12;122;29049;1,03;244,11
242;116;27976;0,97;235,09;122;29171;1,03;245,13
243;116;28092;0,97;236,07;122;29293;1,03;246,16
244;118;28210;0,99;237,06;122;29415;1,03;247,18
245;117;28327;0,98;238,04;122;29537;1,03;248,21
246;116;28443;0,97;239,02;122;29659;1,03;249,24
247;116;28559;0,97;239,99;122;29781;1,03;250,26
248;116;28675;0,97;240,97;128;29909;1,08;251,34
249;116;28791;0,97;241,94;124;30033;1,04;252,38
250;116;28907;0,97;242,92;123;30156;1,03;253,41
251;116;29023;0,97;243,89;123;30279;1,03;254,45
252;116;29139;0,97;244,87;123;30402;1,03;255,48
253;116;29255;0,97;245,84;123;30525;1,03;256,51
254;116;29371;0,97;246,82;123;30648;1,03;257,55
255;117;29488;0,98;247,80;123;30771;1,03;258,58
256;117;29605;0,98;248,78;123;30894;1,03;259,61
257;116;29721;0,97;249,76;124;31018;1,04;260,66
258;117;29838;0,98;250,74;123;31141;1,03;261,69
259;112;29950;0,94;251,68;120;31261;1,01;262,70
260;111;30061;0,93;252,61;121;31382;1,02;263,71
261;110;30171;0,92;253,54;121;31503;1,02;264,73
262;110;30281;0,92;254,46;120;31623;1,01;265,74
263;110;30391;0,92;255,39;121;31744;1,02;266,76
264;110;30501;0,92;256,31;119;31863;1,00;267,76
265;110;30611;0,92;257,24;119;31982;1,00;268,76
266;110;30721;0,92;258,16;119;32101;1,00;269,76
267;110;30831;0,92;259,08;119;32220;1,00;270,76
268;110;30941;0,92;260,01;119;32339;1,00;271,76
269;115;31056;0,97;260,97;122;32461;1,03;272,78
270;116;31172;0,97;261,95;122;32583;1,03;273,81
271;115;31287;0,97;262,92;122;32705;1,03;274,83
272;116;31403;0,97;263,89;122;32827;1,03;275,86
273;115;31518;0,97;264,86;122;32949;1,03;276,88
274;115;31633;0,97;265,82;122;33071;1,03;277,91
275;116;31749;0,97;266,80;122;33193;1,03;278,93
276;116;31865;0,97;267,77;122;33315;1,03;279,96
277;116;31981;0,97;268,75;122;33437;1,03;280,98
278;115;32096;0,97;269,71;122;33559;1,03;282,01
279;116;32212;0,97;270,69;122;33681;1,03;283,03
280;115;32327;0,97;271,66;122;33803;1,03;284,06
281;115;32442;0,97;272,62;122;33925;1,03;285,08
282;115;32557;0,97;273,59;122;34047;1,03;286,11
283;115;32672;0,97;274,55;122;34169;1,03;287,13
284;115;32787;0,97;275,52;122;34291;1,03;288,16
285;115;32902;0,97;276,49;122;34413;1,03;289,18
286;116;33018;0,97;277,46;122;34535;1,03;290,21
287;115;33133;0,97;278,43;122;34657;1,03;291,24
288;115;33248;0,97;279,39;123;34780;1,03;292,27
289;116;33364;0,97;280,37;123;34903;1,03;293,30
290;116;33480;0,97;281,34;123;35026;1,03;294,34
291;116;33596;0,97;282,32;123;35149;1,03;295,37
292;116;33712;0,97;283,29;123;35272;1,03;296,40
293;116;33828;0,97;284,27;123;35395;1,03;297,44
294;116;33944;0,97;285,24;123;35518;1,03;298,47
295;115;34059;0,97;286,21;122;35640;1,03;299,50
296;116;34175;0,97;287,18;123;35763;1,03;300,53
297;116;34291;0,97;288,16;122;35885;1,03;301,55
298;115;34406;0,97;289,13;123;36008;1,03;302,59
299;116;34522;0,97;290,10;122;36130;1,03;303,61
300;116;34638;0,97;291,08;122;36252;1,03;304,64
301;116;34754;0,97;292,05;122;36374;1,03;305,66
302;116;34870;0,97;293,03;123;36497;1,03;306,70
303;116;34986;0,97;294,00;123;36620;1,03;307,73
304;116;35102;0,97;294,97;122;36742;1,03;308,76
305;116;35218;0,97;295,95;122;36864;1,03;309,78
306;116;35334;0,97;296,92;123;36987;1,03;310,82
307;116;35450;0,97;297,90;123;37110;1,03;311,85
308;116;35566;0,97;298,87;122;37232;1,03;312,87
309;116;35682;0,97;299,85;123;37355;1,03;313,91
310;116;35798;0,97;300,82;122;37477;1,03;314,93
311;116;35914;0,97;301,80;122;37599;1,03;315,96
312;116;36030;0,97;302,77;123;37722;1,03;316,99
313;116;36146;0,97;303,75;122;37844;1,03;318,02
314;116;36262;0,97;304,72;122;37966;1,03;319,04
315;116;36378;0,97;305,70;122;38088;1,03;320,07
316;116;36494;0,97;306,67;123;38211;1,03;321,10
317;116;36610;0,97;307,65;123;38334;1,03;322,13
318;116;36726;0,97;308,62;122;38456;1,03;323,16
319;116;36842;0,97;309,60;123;38579;1,03;324,19
320;116;36958;0,97;310,57;123;38702;1,03;325,23
321;116;37074;0,97;311,55;123;38825;1,03;326,26
322;116;37190;0,97;312,52;123;38948;1,03;327,29
323;116;37306;0,97;313,50;123;39071;1,03;328,33
324;116;37422;0,97;314,47;123;39194;1,03;329,36
325;116;37538;0,97;315,45;123;39317;1,03;330,39
326;116;37654;0,97;316,42;123;39440;1,03;331,43
327;116;37770;0,97;317,39;123;39563;1,03;332,46
328;116;37886;0,97;318,37;123;39686;1,03;333,50
329;116;38002;0,97;319,34;123;39809;1,03;334,53
330;116;38118;0,97;320,32;123;39932;1,03;335,56
331;116;38234;0,97;321,29;123;40055;1,03;336,60
332;116;38350;0,97;322,27;123;40178;1,03;337,63
333;116;38466;0,97;323,24;123;40301;1,03;338,66
334;116;38582;0,97;324,22;123;40424;1,03;339,70
335;116;38698;0,97;325,19;123;40547;1,03;340,73
336;117;38815;0,98;326,18;123;40670;1,03;341,76
337;117;38932;0,98;327,16;124;40794;1,04;342,81
338;116;39048;0,97;328,13;123;40917;1,03;343,84
339;116;39164;0,97;329,11;123;41040;1,03;344,87
340;116;39280;0,97;330,08;123;41163;1,03;345,91
341;117;39397;0,98;331,07;123;41286;1,03;346,94
342;117;39514;0,98;332,05;123;41409;1,03;347,97
343;116;39630;0,97;333,03;123;41532;1,03;349,01
344;117;39747;0,98;334,01;123;41655;1,03;350,04
345;118;39865;0,99;335,00;123;41778;1,03;351,08
346;121;39986;1,02;336,02;123;41901;1,03;352,11
347;118;40104;0,99;337,01;123;42024;1,03;353,14
348;117;40221;0,98;337,99;123;42147;1,03;354,18
349;117;40338;0,98;338,97;123;42270;1,03;355,21
350;118;40456;0,99;339,97;123;42393;1,03;356,24
351;117;40573;0,98;340,95;123;42516;1,03;357,28
352;118;40691;0,99;341,94;123;42639;1,03;358,31
353;118;40809;0,99;342,93;123;42762;1,03;359,34
354;118;40927;0,99;343,92;123;42885;1,03;360,38
355;117;41044;0,98;344,91;123;43008;1,03;361,41
356;117;41161;0,98;345,89;123;43131;1,03;362,45
357;117;41278;0,98;346,87;123;43254;1,03;363,48
358;117;41395;0,98;347,86;123;43377;1,03;364,51
359;118;41513;0,99;348,85;125;43502;1,05;365,56
360;118;41631;0,99;349,84;128;43630;1,08;366,64
361;118;41749;0,99;350,83;126;43756;1,06;367,70
362;116;41865;0,97;351,81;128;43884;1,08;368,77
363;117;41982;0,98;352,79;127;44011;1,07;369,84
364;117;42099;0,98;353,77;127;44138;1,07;370,91
365;117;42216;0,98;354,76;127;44265;1,07;371,97
366;116;42332;0,97;355,73;127;44392;1,07;373,04
367;117;42449;0,98;356,71;127;44519;1,07;374,11
368;117;42566;0,98;357,70;127;44646;1,07;375,18
369;117;42683;0,98;358,68;127;44773;1,07;376,24
370;117;42800;0,98;359,66;126;44899;1,06;377,30
371;117;42917;0,98;360,65;126;45025;1,06;378,36
372;117;43034;0,98;361,63;126;45151;1,06;379,42
373;117;43151;0,98;362,61;126;45277;1,06;380,48
374;117;43268;0,98;363,60;126;45403;1,06;381,54
375;117;43385;0,98;364,58;126;45529;1,06;382,60
376;117;43502;0,98;365,56;125;45654;1,05;383,65
377;117;43619;0,98;366,55;124;45778;1,04;384,69
378;117;43736;0,98;367,53;124;45902;1,04;385,73
379;117;43853;0,98;368,51;125;46027;1,05;386,78
380;117;43970;0,98;369,50;125;46152;1,05;387,83
381;117;44087;0,98;370,48;125;46277;1,05;388,88
382;117;44204;0,98;371,46;125;46402;1,05;389,93
383;117;44321;0,98;372,45;125;46527;1,05;390,98
384;117;44438;0,98;373,43;125;46652;1,05;392,03
385;117;44555;0,98;374,41;124;46776;1,04;393,08
386;117;44672;0,98;375,39;125;46901;1,05;394,13
387;117;44789;0,98;376,38;124;47025;1,04;395,17
388;117;44906;0,98;377,36;125;47150;1,05;396,22
389;117;45023;0,98;378,34;125;47275;1,05;397,27
390;117;45140;0,98;379,33;124;47399;1,04;398,31
391;117;45257;0,98;380,31;125;47524;1,05;399,36
392;117;45374;0,98;381,29;124;47648;1,04;400,40
393;116;45490;0,97;382,27;125;47773;1,05;401,45
394;117;45607;0,98;383,25;125;47898;1,05;402,50
395;117;45724;0,98;384,24;124;48022;1,04;403,55
396;117;45841;0,98;385,22;125;48147;1,05;404,60
397;117;45958;0,98;386,20;124;48271;1,04;405,64
398;117;46075;0,98;387,18;125;48396;1,05;406,69
399;117;46192;0,98;388,17;124;48520;1,04;407,73
400;117;46309;0,98;389,15;125;48645;1,05;408,78
401;117;46426;0,98;390,13;125;48770;1,05;409,83
402;117;46543;0,98;391,12;125;48895;1,05;410,88
403;117;46660;0,98;392,10;125;49020;1,05;411,93
404;117;46777;0,98;393,08;125;49145;1,05;412,98
405;117;46894;0,98;394,07;125;49270;1,05;414,03
406;117;47011;0,98;395,05;125;49395;1,05;415,08
407;117;47128;0,98;396,03;125;49520;1,05;416,13
